#   # = # = # = #
|   |       |   |
# = # = #   #   #
|           |   | 
#   # = # = #   #
|   |           |
#   #   # = # = #
|       |   |   |
# = # = # = # = #